NO ./src/textures/GRAYWALL.xpm
SO ./src/textures/GRAYWALL.xpm
WE ./src/textures/GRAYWALL.xpm
EA ./src/textures/GRAYWALL.xpm

F 64,64,64
C 39,41,82

  111111111
111000000011111111111111111111111111111
100000000000001 10000012222210000000001
100000000000001 10000012000210000000001
100000100000001 10000012202210000000111
111110000000001 100000111D1110000000111
100010000000001 100000000000000000001
11D110000000001 100000000000000000001
100000001000001 100000000000000000001
1000001000010011100000011110000000111
100N000000000000000000000000000000001
1111111111111111111111111111111111111
