NO ./text
SO ./text
WE ./text
EA ./text

F 220,100,0
C 225,30,0

   1111111
1110000000111111111111111111111111111
100000000000001 100000000000000000001
100000100000001 100000000000000000001
100000000000001 100000000000000000001
100000000000001 100000000000000000001
100000000000001 100000000000000000001
100000001000001 100000000000000000001
1000001000010011100000011110000000011
1000000000000000000000000000000000001
100N000000000000000000000000000000001
1111111111111111111111111111111111111