NO ./src/textures/qwe
SO ./src/textures/qwe
WE ./src/textures/qwe
EA ./src/textures/qwe

F 220,100,0
C 225,30,0

   1111111
111000000011111111111111111111111111111
100000000000001 10000000000000000000001
100000100000001 10000000000000000000111
100000000000001 10000000000000000000111
100000000000001 100000000000000000001
100000000000001 100000000000000000001
100000001000001 100000000000000000001
1000001000010011100000011110000000011
1000000000000000000000000000000000001
100N000000000000000000000000000000001
1111111111111111111111111111111111111