NO ./text
SO ./text
WE ./text
EA ./text

F HEX COLOR
C HEX COLOR

            1111111111111111111111111111111111111
            1000000000000000000000000000110000001
            1000000000000000000000000000110000001
            1000000000000000000000000000000000001
1111111111110000000000000000000000100001000000001
1000000000000000000000100000000000000000100000001
1000000000000000000000100000000000000000111111111
10000000000000000000001000000000000000001
10000000000000000000001000000000000000001
10000000000000000000001000000000000000001
10000000000000000000001000000000000000001
10000000000000000000001000000000000000001
10000000000000000000001000000000000000001
11111111111111111111111111111111111111111